1111111111111111111111111111111111
1E000000N000000C00000C000N00000001
1010010100100000101001000000010101
1010010010101010001001000N00010101
1P0000000C00C1000000000010000000C1
1111111111111111111111111111111111